Abbreviationes.

 

Abbreviationes.¹)

Ass = Assistentia, Assistentiae.

Ass (de personis) = Assistenffi Assistentes.
C = Collegium, Collegia.

Ο (de personis) = Confessor, Confessores.
GC = Collegium (a) et Convictus.
Gex = Collegium (a) et Dex.

olep == Colonia leprosorum.

cpb z Collegium et pr.

cv == Convictus.

D = Domus.

Dex = Domus exercitiorum.

pr = D. probationis.

D3pb (3pb) = D. tertiae probationis.
Dpr = D. professa.

Dscr = D. scriptorum.

Dst = D. studiorum.

nval = D. valetudin.

nosp = Hospitium (a).

Inst = Institutum (a).

Μ = Missio, Missiones.

M (de personis) = Marty1·‚ Martyres.
orph = Orphanotrophium.

Pr = Provincia, Provinciae.

Pr (de personis) = Provincialis (es).
R = Residentia (ω).

sap = Schola apostolica.

seh = Schola, Scholae.

Sem = Seminarium (a).

st = Statio (nes).

U = Universitas.

V = Vice.

 

¹) Cf. col. 591.

VII

